Actor1	Actor2
CRYER, JON	TOUSSAINT, LORRAINE
FABIAN, AVA	CHAPMAN, MICHAEL (I)
DUNSMORE, ROSEMARY	GADON, SARAH
HICKOX, ANTHONY (I)	CRAWFORD, RACHAEL (I)
MCGILL, MICHAEL PATRICK	FYFE, JIM
BODE, BEN	SHEEN, MARTIN
SNOW, BRITTANY	CAPIZZI, BILL
PHIFER, MEKHI	WOODLEE, ZACHARY
PRINE, LYSSA	IFANS, RHYS
WOZNIAK, MICHAEL	BACH, JOHN (I)
PERRY-RUSSELL, BRITTANY	WADE, MADELEINE
SINGLETON JR., ISAAC C.	FENN, SHERILYN
MANTEL, HENRIETTE	ROHR, TONY
GREENBERG, BRYAN (II)	DRIESSCHEN, MARKE
MOE DEE, KOOL	MOUSER, MARY (I)
ABRAMS, PATSY GRADY	CRESCENZO, JAMES
BEASLEY, MICHAEL (I)	MCINTOSH, YANNA
EVE, ALICE	JONES, JANUARY (I)
MACANINCH, CAL	RAYNOR, MICHAEL
LYMAN, GEORGIA	FRANKLIN, ROSHAWN
