Actor1,Actor2,Actor3,Actor4
DE NIRO, ROBERT	LEBLANC, ELTON	HALEY, EMILY D.	LEBLANC, CYNTHIA
JACKSON, SAMUEL L.	HAWN, PHIL	RIEHLE, RICHARD	SARANDON, SUSAN
MARSHALL, GARRY	ELIZONDO, HECTOR (I)	MCGEE, JACK (I)	MILLER, LARRY (I)
ROACH, MARTIN (I)	PAUL, BRIAN (I)	FITZPATRICK, RICHARD (I)	PODHORA, ROMAN
WELKER, FRANK	ROSALES JR., THOMAS	POLITO, JON	SCHIFF, RICHARD
HINDS, CIAR·N	COHEN, LYNN (I)	KINGSLEY, BEN	CRAIG, DANIEL (I)
KENYON, DAVID DUSTIN	SIEVERS, GARY	MODINE, MATTHEW	PAPAJOHN, MICHAEL
STRONG, BRENDA	JOHNSON, ERIC (I)	FORD, COLIN (I)	HENNINGS, SAM
FOLSE, GABRIEL	RENTERIA, GEORGE	CERVENKA, GENE	GAINEY, M.C.
LYNCH, JANE (I)	SHANNON, MOLLY (I)	DOWNEY JR., ROBERT	ROGEN, SETH
COBB, FRANCES	GRIFFIS, RHODA	WARREN, STEVE (III)	KNOWLES, SHAWN
BETTS, ERIK	COUTURE, RANDY	RHEE, SIMON	BRENNA, TROY
CANNON, KEVIN (I)	HERRMANN, EDWARD	UZIMANN	ROCK, CHRIS (I)
DAWSON, ROSARIO	LERMAN, LOGAN	BANKS, ELIZABETH (II)	UZIMANN
FIDDY, JAMES	KNIGHTLEY, KEIRA	MCAVOY, JAMES	REDGRAVE, VANESSA
CHALK, GARRY	JACKSON, DEE JAY	WASSERMAN, JERRY	MITCHELL, PHILLIP (I)
MONTE, TED	GABAI, RICHARD	HOWARD, RANCE	RICHARDSON, JAY (I)
TATASCIORE, FRED	JACKSON, SAMUEL L.	HONG, JAMES (I)	ELLIS, GREG (II)
CALDWELL, ANDREW (II)	SANDLER, ADAM (I)	BALDWIN, ALEC	HOWARD, RANCE
ZAMBRANA, MARIA	STARR, ARNE	HILL, JONAH	COHEN, DAVID (XXI)
