Actor1,Actor2,Actor3,Actor4
DE NIRO, ROBERT	HOWARD, TERRENCE (I)	FREEMAN, MORGAN (I)	GRIFFIN, DOUGLAS M.
JACKSON, SAMUEL L.	HAWN, PHIL	BALDWIN, ALEC	JENKINS, RICHARD (I)
DE NIRO, ROBERT	COOPER, BRADLEY (I)	HOWARD, RANCE	ELIZONDO, HECTOR (I)
FITZPATRICK, RICHARD (I)	BARTON, RODGER	CAMPBELL, DESMOND	BURDON, CATHERINE
AARON, CAROLINE	JENKINS, KEN (I)	CHREST, JOE	FISHER, DAVID C.
HINDS, CIAR·N	COHEN, LYNN (I)	CRAIG, DANIEL (I)	BANA, ERIC
KENYON, DAVID DUSTIN	FREEMAN, MORGAN (I)	BLEVINS, RONNIE GENE	ELLIS, CHRIS (I)
FORD, COLIN (I)	HENNINGS, SAM	JOHNSON, ERIC (I)	FITZGERALD, WILBUR
FOLSE, GABRIEL	GAINEY, M.C.	CERVENKA, GENE	DOUGLAS, JASON (IV)
HILL, JONAH	CARELL, STEVE	DOWNEY JR., ROBERT	HIGGINS, JOHN MICHAEL
COBB, FRANCES	GRIFFIS, RHODA	HOPKINS, BARRY (II)	FITZGERALD, WILBUR
BETTS, ERIK	COUTURE, RANDY	BRENNA, TROY	KEIFFER, DENNIS
CANNON, KEVIN (I)	HERRMANN, EDWARD	GOODMAN, DANA (II)	FAVREAU, JON
DAWSON, ROSARIO	KUCHMA, ANNA	BANKS, ELIZABETH (II)	HILL, JONAH
FIDDY, JAMES	KNIGHTLEY, KEIRA	ALLEN, ALFIE	ANOZIE, NONSO
CHALK, GARRY	JACKSON, DEE JAY	BRYANT, PETER (I)	ABRAHAMS, DOUG
GABAI, RICHARD	GARCIA, JSU	HOWARD, RANCE	HAGEN, ROSS
HONG, JAMES (I)	JACKSON, SAMUEL L.	CURRY, TIM (I)	ELLIS, GREG (II)
CALDWELL, ANDREW (II)	BALDWIN, ALEC	BANNOS, STEVE	HART, KEVIN (I)
HILL, JONAH	COHEN, DAVID (XXI)	HIGGINS, JOHN MICHAEL	HOWARD, RANCE
